12:12
0 0 0 0 18 0 0 0 0 0 18 18
6 0 0 0 0 0 0 0 0 0 0 18
2 4 2 2 2 18 18 18 2 0 0 0
0 0 0 0 0 0 0 0 2 0 0 2
2 2 2 2 0 0 0 0 2 0 4 0
0 0 6 2 0 0 0 18 18 18 0 0
0 0 0 2 2 4 18 8 6 18 18 0
0 0 0 0 0 0 18 6 0 6 18 0
18 0 0 2 2 0 2 18 0 4 0 0
10 0 0 2 2 0 0 6 18 0 0 0
0 0 0 2 2 2 2 18 0 0 0 0
0 0 0 2 2 2 18 0 0 0 3 11
