12:12
9 2 0 0 0 0 0 0 0 0 0 0 
3 2 0 2 2 2 2 2 2 2 2 4
0 2 0 2 6 0 2 0 4 1 2 4
0 2 0 2 0 0 2 0 4 4 2 4
0 2 4 2 0 0 0 6 2 2 2 0
0 2 4 0 0 0 0 0 0 2 6 0
6 2 0 0 0 2 2 0 0 2 6 0
4 2 0 0 0 2 2 0 0 2 2 0
0 2 0 0 0 0 0 0 0 0 2 0 
0 2 0 6 0 0 0 0 6 0 2 0
0 2 2 2 2 2 2 2 2 2 2 4
6 4 0 0 0 6 4 0 0 0 0 6
