12:12
9 2 0 0 0 0 2 0 0 0 18 18 
3 2 0 0 0 0 2 0 0 0 0 6 
0 2 2 2 2 0 2 0 2 2 2 2 
0 0 0 0 0 0 4 0 0 0 0 0 
18 18 18 18 4 18 0 18 18 18 18 18 
0 0 0 0 0 18 0 0 0 0 0 0 
6 0 0 0 0 0 18 18 18 18 0 0 
0 2 0 0 0 0 0 0 0 0 0 0 
0 0 4 0 0 0 0 0 0 0 0 0 
0 0 2 0 2 0 0 4 2 2 2 2 
0 0 2 0 2 0 0 0 0 0 0 0 
11 0 2 0 0 0 0 0 0 6 0 8 
